--------------------------------------------------------------------------------------------------------------------------------------------------------------------------------------------------------------------------------------------
|##  ##        ##  ##          ########  ##    ##    ##    ######  ########      ####    ##      ##############  ##  ##    ##  ##  ####  ####  ##      ####  ####  ######  ##  ####  ##  ##  ##    ####################  ####  ##    ######  |
|####  ##  ####    ####  ##  ##  ########    ##########  ##  ####  ########  ####  ##        ######  ##  ##  ####################        ######  ####  ######  ##  ####  ##  ##    ########  ##  ##  ##########  ##########  ##      ##  ####|
|######  ####  ############  ######################  ##########  ##  ##  ######  ########      ##        ######  ######  ####  ################  ######    ##  ##########  ##############  ##    ##############        ####  ####  ####      |
|############  ##  ##  ##  ##    ##        ########  ##      ####  ####  ######  ##        ######  ##    ########  ##  ######  ####    ############  ##  ##  ##    ##  ##    ##    ######    ##  ########  ##  ########    ##########  ######|
|####                ####  ####  ####  ####  ######  ####    ####  ############  ################  ############  ########    ##  ########  ######  ####  ######  ##  ##  ##  ####  ############    ##  ####    ######    ######  ####  ##    |
|    ####  ##  ######      ########  ####  ##      ####      ##  ########      ########  ############  ######  ####  ########    ####      ########  ######  ####  ######  ##################    ##      ##########    ##        ####  ##  ##|
|##############  ########  ##  ##  ##  ####    ####    ########          ##  ##  ##  ########    ##  ##    ##  ######  ##########  ####  ##  ##  ####  ########    ########  ##  ##        ##  ######  ####    ##  ##      ####  ########    |
|##########  ####  ##  ########  ########    ##    ##  ##      ##  ##  ##    ##    ####      ################    ######  ##    ####  ##        ######    ##    ##  ##    ##  ######    ##  ####  ####  ############    ##  ####  ##  ##  ####|
|  ####      ##        ####    ######  ####  ##  ##  ####  ####  ######      ##  ##      ##  ######  ####  ######  ######    ##    ##########  ##  ##############    ##  ##  ####    ####  ####    ######  ####  ##  ####  ##########    ####|
|  ####    ############      ##    ####  ##  ##  ##    ########  ##  ####  ##      ####  ##################  ################  ############  ####  ##  ##  ##########    ######  ########  ##    ##          ##    ####  ######  ########    |
|      ######  ####  ##  ####  ##  ##########  ##    ##    ######  ##############  ##########    ########  ######  ########  ########  ####################  ##    ##    ####  ####  ##  ########  ######  ##  ########      ##########    ##|
|######  ##        ########  ##############    ##    ########  ####  ########  ####  ####    ##    ########  ##      ##  ####  ##  ######  ############  ##  ############    ######    ##  ########  ##        ##########    ####  ##  ####  |
|##    ####  ####  ##  ######  ##  ##  ##########  ##  ##      ####################  ######  ####  ####  ########  ####################  ##  ##    ######      ##########  ##  ##  ####  ##          ########    ##    ##############  ##  ##|
|############  ####  ##    ######      ##  ####  ##########  ##        ########  ######  ##  ##  ######  ######    ####    ######      ####  ######  ####    ##  ########  ##  ##############  ####  ########  ##  ####    ########    ##  ##|
|############  ##    ######  ############  ############  ##  ##  ############  ######  ##    ##########    ##  ######  ##  ##  ####  ##########    ##    ########  ########      ##  ##############      ##########  ##  ##  ######  ####  ##|
|      ##      ####    ####    ####  ##  ##  ######    ####  ##  ##  ####  ####  ##  ##  ####    ################################    ######    ####  ##  ##  ##      ####  ########    ##############      ####  ##############  ############|
|  ######  ####    ##      ##########          ############  ##  ##  ######  ##  ######          ########      ####    ######      ##    ####  ##  ####      ############    ##############    ##  ##  ########    ##  ##  ##  ##      ######|
|####  ##    ####################    ####  ####  ######  ##  ######  ################  ####  ##      ##  ####  ##############  ########      ##################        ######    ##  ##    ######  ##################  ######  ####  ########|
|##  ####  ####  ####    ####  ######  ##    ####        ####  ####        ##  ######      ##  ####  ######    ########    ######  ####    ##  ##    ####  ####  ######    ####  ####  ##############      ##      ####    ##  ##      ##  ##|
|    ##  ##  ##    ####    ########      ####  ##  ########  ######    ##  ####          ####    ##  ##        ####      ########      ##  ##  ################  ######  ######  ####    ####    ########  ##  ##########  ##    ##########  |
|    ##      ########  ####    ######  ##  ##  ##      ####  ######    ##  ##########  ##  ##  ##    ####  ####        ##  ##    ######      ##  ##  ######      ##  ####        ##  ####    ####    ######  ##  ####      ##########    ##  |
|  ##      ####  ##  ####    ##        ##  ##  ######    ####  ##      ##      ####  ######    ####    ######  ####        ##      ##  ####  ##      ##    ########    ######  ##############  ####    ########  ##########  ######          |
|  ########  ######  ########  ##    ##  ##    ##  ######  ########      ####  ##  ######  ############  ##  ######        ########  ######        ######  ######  ######    ##  ##    ####  ####    ##  ######  ##    ####  ##  ####  ######|
|  ################        ##  ####  ####    ##    ##############    ############    ####      ##  ##  ########          ##  ########  ############  ####  ######  ##  ####      ##  ##    ##  ##      ####  ##  ########  ##    ####    ####|
|####  ######  ##    ########      ##          ########  ##    ##  ##########    ####  ####  ######      ##  ##  ####  ####          ##  ##  ##  ######  ##    ##########  ####  ######  ########  ####  ########  ######  ##########    ####|
|    ####  ######  ##  ########  ##########  ####  ######  ########  ######  ##  ######  ##  ################  ############  ##  ####  ####  ####  ##############  ####  ##  ########  ##      ####        ##  ##  ##      ##  ########  ##  |
|##############  ##########################  ##  ##########  ##          ####  ##############  ##  ####    ####  ##      ##  ##########    ##  ####  ########  ##  ##  ########  ########  ##########  ######  ########  ######    ##  ##  ##|
|############    ####  ################  ####  ######    ####  ####    ##############################  ################    ##  ####  ######  ########  ##########  ##        ##  ########    ##########  ##  ####  ##    ############  ######|
|##        ##  ################      ##  ####  ####    ##############  ##  ##    ####  ########  ####  ##      ##  ######    ######  ##  ######        ##  ######  ############  ##  ##  ##################      ##    ##  ####    ####      |
|####  ##  ######  ##  ##    ##  ########################    ####  ############    ##  ##  ########        ####            ########  ####  ####          ####  ##  ##  ############  ##    ############  ######    ##  ####  ##  ##  ##  ##  |
|##########  ##########      ##  ####    ####  ####  ##########  ####  ##  ##  ######  ##################  ##    ####  ##  ##########    ############  ##    ######  ##  ##  ##########  ##  ######    ##  ############  ##########  ########|
|    ##    ##    ####    ##  ####  ##  ##  ##  ######  ##  ##########  ##  ######  ##  ######  ####  ####  ########  ########  ########      ##      ##  ##    ####  ##  ########  ##  ############    ##    ##  ##########  ##  ##  ####    |
|########    ####    ##############  ######  ##########  ####  ##      ##########  ##  ######    ############  ############  ####  ##  ####  ##  ##  ########        ######  ##    ##########  ######    ######  ####    ########  ####    ##|
|########  ######    ####    ####  ######  ########  ##        ##########  ##  ######  ######  ####  ##          ######    ##  ##  ######  ######  ##  ##  ####    ##########  ########  ##    ################  ##          ########  ######|
|  ##  ############    ####  ######  ##    ####  ####      ####  ####    ##  ##########  ##  ##  ##  ############    ##############  ##  ##  ##  ########  ######      ####  ####  ####    ########    ####  ########  ####    ##    ########|
|######    ######  ######  ################          ####  ##    ####  ######  ##      ######  ##    ########  ##  ##  ######      ##  ##  ####  ######  ##    ######    ##########  ##  ##    ##        ####            ######  ####    ##  |
|######  ##      ##########  ######    ##################  ##  ####  ######      ##    ##  ####  ####    ####  ##    ######  ####  ##  ######  ##  ########  ##    ##      ##  ##  ######  ####      ##########  ##    ##########  ####  ####|
|  ####  ##  ##  ##      ##      ######  ####################    ####  ##      ##  ####      ######  ####    ##    ##  ##  ################  ##  ##    ##  ##  ################    ####    ##    ##  ######  ##  ##  ##  ######      ##  ##  |
|##        ##  ##########        ##    ##  ####    ##############  ##  ##  ############  ########  ####    ########    ####      ##############  ########  ##        ####      ####  ########    ######    ####  ##############  ######  ####|
|############  ##############  ####  ######  ##########  ####  ##############  ##  ##  ##  ##  ####      ##  ####    ######  ####  ##    ##  ####  ####  ####  ##########    ####      ##    ############  ########    ##########  ##########|
|####  ##  ############    ############  ##########  ####  ####  ######      ##########  ##    ######  ##        ######  ##################    ##    ##########  ########    ########        ####  ############    ####  ##  ########  ##  ##|
|####  ########          ##  ######  ######  ##    ########  ########    ##########  ##  ############  ####    ########  ####  ####  ##  ##########    ########      ####  ##  ####  ######  ##    ####    ############  ##########  ##    ##|
|######    ########    ######    ####  ####        ##    ############  ##  ##    ##  ######  ####    ####    ########    ####    ############      ######        ##  ##  ##  ##  ##  ##  ####  ########    ##  ##  ####    ####  ####        |
|  ##  ##########  ##      ############  ########################  ####  ########  ####  ######  ######################  ##############    ####        ##  ######      ##  ##  ##############      ##  ############  ####  ######  ####  ####|
|  ######    ##########  ########    ##########      ##  ##################      ######  ##########    ######  ##  ##  ##          ##    ##  ##  ##  ####  ####    ####  ##  ########  ######  ########      ############  ##    ##    ##  ##|
|##  ######  ######    ##  ##########  ####    ##################  ##          ######    ##        ####    ####  ##  ##      ########    ##  ##        ##    ##  ##############  ####    ######    ####    ####  ##########    ##############|
|######  ##############    ####  ##  ################    ######  ##          ######  ####    ##  ##    ##########    ####  ######  ##  ####  ##############    ##  ####    ####      ######  ####  ##    ################  ######    ##  ####|
|  ########  ######  ##########  ##  ####  ##  ##  ####  ####    ##########  ##############  ##########  ####  ##  ##  ##  ##########  ######  ##  ##  ##########    ####    ######  ####  ##############  ########  ##  ####  ########  ####|
|  ######  ######  ##  ########      ##########    ######  ######  ######  ##    ############  ##########    ######  ##  ##  ######  ##    ######  ######    ##  ######  ####    ##########  ##      ##    ##  ####  ######      ######    ##|
|  ##  ####  ########  ##  ##      ########      ##  ##  ##    ######    ########        ########    ########        ##  ####    ######    ########    ####  ####  ####    ############    ##############  ##        ##    ######        ####|
|  ##  ##########  ######    ####    ##  ##  ####  ######  ##    ####  ##############    ####    ##  ##  ##    ############      ####  ##  ################  ##        ##  ####          ##    ####    ####  ##  ####  ##      ##      ######|
|  ####  ####    ##      ####  ################        ##  ####  ##    ##  ####  ####  ########  ##  ##  ##      ##########  ##    ##      ##    ##  ######    ##  ##################  ##########  ########  ##    ##  ##    ####  ####  ####|
|##########  ##########    ##    ##  ########  ##  ####  ##  ##  ##  ##  ##############    ########  ####    ######  ####    ##    ##  ######  ##    ##    ##############  ##  ####    ##  ######      ##############################  ####  |
|  ##########  ##########  ############  ####  ########  ##########    ##  ######  ##  ##  ####  ######################    ####  ################  ##      ##  ####  ######    ################    ######  ######  ####  ########    ####  ##|
|################  ########    ######    ##      ########  ##      ##################  ##    ##  ##    ##    ##########  ####  ####  ##  ####  ####  ##############    ################    ######  ####  ########        ######  ########  ##|
|############    ##########  ##  ##########  ########    ####          ####  ######  ####  ######  ####      ##    ################  ####  ##  ################    ##    ##    ##  ######  ##  ##  ##  ##########  ##        ########  ##    |
|################  ######    ##    ##  ##        ##########  ####  ##########    ########    ####    ########    ######  ##############    ######  ##    ####    ##  ####      ##    ##  ####  ##  ##  ##  ########  ##    ######  ##  ######|
|  ##########  ####  ####    ####  ####  ##  ######    ######      ####  ######  ##                ####    ##    ####    ######  ##      ######  ####    ####    ####  ####  ##  ##  ########  ####  ####      ##  ##  ##########  ##  ######|
|######    ##########  ####      ####  ##    ######  ####  ########  ####  ##########    ############  ####    ##    ##  ##  ############  ##  ##    ##    ####    ####  ##  ####  ##    ######  ##################    ####      ##  ##  ####|
|########    ##  ######  ######      ##############    ##          ####    ########    ######    ######  ####  ##    ##############  ##########    ########  ##  ##    ####################    ##########  ####      ##############  ##  ####|
|##  ########  ####  ##  ####    ####  ##  ######    ##    ########    ####  ######    ####  ######  ####    ##    ##  ##  ####  ####  ##  ####  ##  ##  ########  ##  ##  ##########  ##  ##  ##########  ####  ##  ##  ####  ########  ####|
|  ##        ##########        ##################    ######              ##  ##########  ####    ########                    ##  ##        ##  ############      ##    ##  ##  ##    ##########  ####  ##  ##  ##  ########  ########  ######|
|      ##    ####  ####  ####  ##  ##############################      ##      ##  ##  ######    ##  ##########################    ######  ##  ##    ####      ####  ########  ##    ######  ######      ##    ####  ##    ####  ######  ##  |
|########  ######  ######  ##  ######################    ######  ####    ####  ##  ####    ######  ##########    ####  ####  ####  ########  ##########  ##########  ####  ##########  ##  ############    ##  ####    ##########  ######    |
|##      ####################  ######    ##############  ######  ####  ######      ##  ##############  ######  ##  ######        ######    ##  ##    ######  ####  ##  ############  ##########  ##  ####  ####  ######    ######  ##########|
|######      ##  ##      ########  ##    ####  ##########  ####  ####    ######  ##    ########  ##      ####    ######  ####    ##  ######  ####  ######    ##    ##  ##  ##################    ##########  ####  ########  ####  ########  |
|####    ##    ##  ############    ##    ############  ####################################  ##      ####    ##########  ############  ##########################      ############    ##      ######  ####    ##  ##############    ########|
|  ##########  ##  ##  ##    ##  ##    ####    ########  ######  ############  ########      ##    ##  ##  ############  ############  ##  ##  ##  ######  ##########  ######    ##  ########    ####    ####  ##      ##  ############  ##  |
|######  ####  ####  ######    ########  ######  ##  ##########  ####  ##  ##########      ##  ######  ##  ######    ####  ##  ##    ######  ##  ######    ##    ######    ##    ##  ####  ########    ##########  ######  ########    ####  |
|            ##  ######          ########      ##    ##  ######        ####  ######################  ####    ########  ######    ####  ##    ############  ####  ####  ####  ##    ##############  ##  ######  ########    ##      ######  ##|
|  ########    ##  ##    ########    ####  ########  ##  ##    ########  ############  ####  ##  ######  ####  ##########      ############  ##  ##############      ##      ####    ######  ################  ####  ####    ##  ##  ##      |
|######      ######  ########        ##              ##  ####  ########  ##########  ######  ##  ########    ########    ######  ####  ########      ##  ########    ############  ########  ##############  ##  ########  ######  ##    ##  |
|  ################  ####  ##      ########  ######      ##      ##    ##    ##########  ####    ####      ############  ##  ##    ####        ##########  ##################  ######  ####    ####  ####  ####  ##  ######  ####    ####  ##|
|##      ######  ##  ####  ##    ################  ############      ####  ########    ##  ####  ####      ######    ########################  ####    ########  ##      ################    ##  ##      ##  ##########  ##  ##  ##########  |
|##    ################  ####  ####  ########        ##    ############  ##  ##  ####  ######    ####      ##  ####  ####################    ######  ####    ######  ####    ####  ##  ##  ##    ######  ##########    ####  ############  ##|
|##  ####################  ##    ##############  ####  ##    ####    ##  ######  ######  ####  ##########  ##  ##  ####  ##      ####  ####    ######  ##############  ######  ########  ##  ####    ##  ##    ########  ######      ######  |
|  ############    ############  ######  ##    ##        ####  ############  ####################  ####  ##########  ##########  ##  ####  ##########  ####    ################    ########  ################  ######  ##    ######      ####|
|    ########  ######      ####      ####  ##  ####    ####  ####    ##    ################  ##    ######  ##  ##  ##  ####  ########  ####  ##  ######  ##  ##  ######  ##  ##  ##  ################    ##  ####  ########    ######  ######|
|    ####  ##########  ##    ############################  ##      ####    ##    ####  ######      ##  ########  ############  ##  ######  ####  ######  ##  ####  ######  ######  ######  ##  ####  ##    ########  ##  ####  ####  ##  ####|
|##      ########  ##  ####  ########    ####    ##  ##  ##  ########      ##########    ##  ####  ########      ####    ######    ########    ####  ##  ########  ######  ##  ####  ##  ##    ########  ##  ########  ##  ####      ##      |
|##  ##    ##      ################  ################      ##########    ####  ##  ########  ######  ##    ##  ######    ############    ##  ##  ##  ##      ########    ####          ######  ######  ##########  ########    ##########    |
|####    ####      ####    ##  ##            ####        ####  ####          ########      ##      ################    ######  ##############  ####    ##      ##  ########        ####  ##########    ####################      ####    ####|
|  ##      ##    ##  ##  ############  ##  ####          ##############  ##    ##    ##########################  ######  ##############      ######  ########  ##  ##########  ##  ####    ##  ####        ######  ########  ##  ##      ##  |
|  ##    ##      ##########        ####    ##########    ##########  ##################  ##  ##  ##    ##  ##  ######  ############      ####  ##  ####    ##  ##  ##############  ####    ####    ####      ######  ######    ####    ##  ##|
|##  ##  ######  ######  ####    ########  ##      ##    ######  ##############    ########    ####  ##  ##  ####  ######  ##      ######  ##  ######    ##  ##      ##    ########      ####  ####  ##  ########  ####  ######  ########  ##|
|  ##  ######  ##  ######    ######    ####  ########  ##    ####  ##    ##########  ####    ##  ####  ################    ##  ########  ##############  ############  ########  ##  ##########          ##    ####          ####    ########|
|##  ##      ####  ##############      ############      ##  ####  ############  ####  ##  ####  ##########  ##########      ####    ######  ######  ####  ######  ##      ##########  ##  ####  ##    ####  ####    ######  ############  ##|
|####  ####  ############      ######  ##      ##  ####  ######  ####    ####################  ####  ##  ##  ######  ########  ##      ####  ##  ##########  ######  ##    ######  ##  ##  ##  ############    ##############  ######    ##  |
|######  ####  ##############  ##  ######    ######    ########        ##########################  ##  ##    ##########          ##  ##    ##########    ##########  ##  ####  ##################  ##    ####    ######    ##########  ######|
|############################    ######  ##    ##########    ##  ##    ####  ############  ##  ##    ####    ####  ############    ################  ##        ######    ####      ##  ########  ##  ######        ##    ########  ##########|
|####  ##      ######  ####  ##########    ####          ####  ######  ####  ##  ##    ####  ##  ##  ##########  ##    ################        ##  ##  ########  ##  ##########  ####        ##########  ##    ####  ##    ####  ##  ##      |
|##  ##  ######          ####      ######  ####  ##  ########  ####  ####    ##  ##  ######  ######    ########  ##  ####  ##                ##############  ##########  ##          ####  ####    ##  ##  ######  ####  ##  ##########  ####|
|        ##############  ##    ############  ##  ####  ########  ####  ########  ##########    ####  ##      ##          ##  ##  ####  ####  ##  ##########    ####        ############  ##  ######  ############  ##      ##  ##          ##|
|  ##  ##      ######  ####  ##    ##  ##  ##########  ##  ####  ############    ########  ######  ##  ######  ####  ########  ##########  ####  ########  ####    ####  ##########  ####      ####  ####  ##  ##  ##      ##  ##  ##    ####|
|##  ######  ##    ##  ##    ####        ##  ##  ##    ##########################    ##  ####  ########      ##  ##########  ########################  ##############    ##  ##  ##  ##    ##    ######    ########  ##  ##  ########    ####|
|##  ########  ######    ##  ##########    ######  ############  ##        ##  ######  ##  ##########  ##########  ####  ##############  ######  ##        ##  ####  ##########  ########  ######    ####  ########  ####  ######  ##    ##  |
|##########    ##    ##    ######  ######  ####    ####  ##  ##########    ##  ########  ######  ######      ##    ##########  ##  ####    ########  ##    ########  ####    ##  ##  ####  ##############################  ##        ##  ####|
|##  ####  ####  ########  ##    ##  ##    ##########  ####      ##  ##      ##      ##      ##    ####  ########    ####    ####  ######    ############  ##  ####      ##########  ##    ##  ####  ######        ####  ####  ##############|
|######  ##  ########    ##########  ######      ##  ########    ##  ########      ##  ##    ##  ####    ##      ######  ########  ##########  ####    ####  ######      ########  ##  ####  ##  ##########    ########  ##  ##############  |
|############  ######  ##  ####    ######      ############  ########      ##  ####  ####    ####  ##      ######  ##    ######    ######  ######  ##  ####  ######  ####    ####        ####    ######  ####    ##  ##        ##  ##########|
|########    ########  ######  ##############    ######  ########  ####  ########  ########  ########  ########    ##########    ######  ########  ############    ####  ##  ####  ##  ########  ####################    ######  ##    ######|
|########  ##    ##  ##  ######      ##  ####    ####  ##  ########  ##    ########  ########    ##  ####  ##########  ######          ########  ##  ##  ##  ######  ####  ##    ##    ##  ##  ####  ####  ##  ##    ##  ##############    ##|
|####    ######    ##      ########  ##    ########  ############  ##  ##  ############    ##  ########  ####  ####  ##  ##      ##  ####  ##  ##  ##    ##########  ##  ####  ##  ######      ######  ##########    ####  ######  ########  |
|##    ####    ######  ####  ############        ######      ########    ##    ##    ####    ##  ##        ##    ##    ##########  ##    ####    ##  ########  ##    ################  ##          ################    ####  ####  ##    ##  |
|########    ######    ##  ##      ########    ############    ######  ##    ##  ##    ##  ##  ##################  ##  ##########  ##########  ##  ####    ####  ########    ##      ####  ####  ######    ####    ##    ######    ##    ##  |
|####  ############  ####  ############    ######  ##########    ######  ##  ##  ##    ########  ##  ##  ################  ##  ####  ####      ##########  ##  ##  ####        ##########      ####    ########  ######        ######  ####  |
|##  ##  ##  ####################      ##  ##  ######  ##    ####  ####  ######  ##    ####  ######  ################  ##        ####    ####  ####    ##  ########      ##  ########  ######  ######  ############        ##  ##  ##  ######|
|########  ##    ####  ####      ####  ##############    ####    ########      ####        ##########      ##############    ##  ####  ##################      ##        ##  ########    ####  ########  ########  ##    ######  ####    ####|
|##    ##  ########  ######  ##      ##  ####  ####  ##  ##    ####  ######  ########  ####  ##  ######  ##      ####  ################  ##  ####  ######    ####  ####  ########  ##    ##    ########  ####  ####      ########  ##    ####|
|########  ########    ######################      ##########  ####  ##        ####  ##  ######    ####    ######  ##########  ########  ####    ######  ####  ##  ########        ##  ####  ##  ##    ######  ##  ########    ######  ##  ##|
|##  ############  ##  ######        ##    ##  ##  ############  ####    ############  ##    ####################################  ####  ########    ####    ######  ##  ##    ##  ################    ##    ######      ######  ##  ##    ##|
|########          ##      ##  ####  ##########    ################    ########  ##########  ##  ####      ########  ####    ##  ##  ##    ##    ####    ##  ####  ##  ######  ######  ######    ####        ############          ####  ####|
|####  ##  ########    ##  ##    ####  ##        ######    ##  ####      ##    ##  ##    ######  ####  ##  ####  ####  ####    ##  ####  ######  ##  ##    ##    ####  ####  ##  ######    ##      ######  ########    ######      ##########|
|########  ##  ######    ####  ##########  ####  ##    ########  ####  ##  ####  ####  ########    ##########    ################  ##  ##      ######    ########  ########  ##  ########      ####  ##  ##  ##  ############  ##########    |
|  ####  ########  ############      ####  ####  ####      ########  ####  ##      ##########      ####      ##    ####  ##  ##    ##    ####    ######  ##  ##      ##########  ##  ##        ##  ######  ####  ##  ####    ########  ######|
|########        ##    ##  ##  ##########  ######  ##############  ##                  ##  ######  ##########      ####    ########    ####  ########  ########    ####  ################  ##########  ####  ######    ##  ##    ####    ####|
|####            ##    ############        ############  ##  ##    ##  ####    ##  ############################        ######        ################  ##      ##    ##  ##      ####        ##  ##  ####    ########  ##        ##  ######  |
|##  ######          ####    ##  ######  ##          ######  ######    ####    ##    ##    ##########  ######  ########  ##                    ############################  ####  ##  ##        ######    ##  ##########      ####  ####    |
--------------------------------------------------------------------------------------------------------------------------------------------------------------------------------------------------------------------------------------------