--------------------------------------------------------------------------------------------------------------------------------------------------------------------------------------------------------------------------------------------
|############################################################################################################################################################################################################################################|
|########################################################################################    ################################################################################################################################################|
|############################################################################################################################################################################################################################################|
|############          ######################################################################################################################################################################################################################|
|############            ##################################################################################################################################################################################################  ################|
|############            ##############################################################################################################################################################################################        ##############|
|##########              ##############################################################################################################################################################################################        ##############|
|########                  ############################################################  ####################################################  ########################################################################        ##############|
|######                        ########################################################################################################################################################################################        ##############|
|######                          ########################################################################################################################################################################    ##########        ##############|
|####                            ########################################################################################################################################################################      ########        ##############|
|######                            ######################################################################################################################################################################        ######        ##############|
|########                            ######################################################################################################################################################################        ##          ##############|
|########                              ######################################################################################################################################################################                ################|
|########                                  ####################################################################################################################################################################            ##################|
|########                                    ################################################################################################################################################################################################|
|##########                                    ############################################      ############################################################################################################################################|
|##########                                      ######################################            ##########################################################################################################################################|
|##########                                        ##################################                ##############    ######################################################################################################################|
|########                                            ##############################                      ########              ##############################################################################################################|
|########                                              ##############################                      ######                ##############  ######################################################################################  ####|
|##########                                            ############    ##############                      ######                ##############    ##################################################################################      ##|
|##############                                      ############      ##############                      ######                  ############    ##################################################################################      ##|
|##############                                      ############      ################                    ######                    ################################################################################################      ##|
|################                                    ############      ##################                    ####                        ############################################################################################      ##|
|##################                                ##############      ####################                  ######                        ##########################################################################################      ##|
|####################                              ##############        ####################                ########                      ############################################################################################    ##|
|##########################                      ################        ######################              ########                      ############################################################################################    ##|
|##########################                      ##################      ########################              ######                      ##########      ##################################################################################|
|########################                        ####################    ##########################            ######                        ######          ################################################################################|
|########################                        ####################    ############################          ########                                          ############################################################################|
|########################                      ########################################################          ######                                            ##########################################################################|
|########################                      ##########  ##############################################          ######                                            ##################################################    ##################|
|########################                                    ##############################################          ######                                            ##############################################        ################|
|########################                                      ##############################################        ######                                              ##########################  ##############          ################|
|########################                                        ############################################        ########                                            ########################      ##########            ################|
|########################                                        ##############################################        ######                                                ##################          ########          ##################|
|########################                                        ##############################################        ######                                                  ##############              ######          ##################|
|########################                                        ############################################          ######                                                  ##########                  ######          ##################|
|######################                                          ########################################              ########                                                ##########                  ########        ##################|
|####################                                          ##########################################                ######                                                ##########                    ######        ##################|
|##################                                          ##############################################              ########                                              ##########                    ######        ##################|
|##################                                          ####################################################                                                              ##########                    ########        ##########  ####|
|##################                                        ######################################################                                                              ############                  ##########        ##############|
|####################                                      ############      ####################################                                                                  ########                  ##########        ##############|
|######################                                    ############        ################################                                                                      ########                ############    ################|
|##########################                                ############          ##############################                                                                      ########                ################################|
|##########################                                ############              ##########################                                                                    ############                  ############################|
|##########################                                  ############              ######################                                                                          ##########                  ##################  ######|
|##########################                                    ##############            ##################                                                                              ########                    ##############      ####|
|##########################                                    ################            ##############                                                                                ########                    ##############      ####|
|##########################                                    ##################          ################                                                                              ########                    ##############        ##|
|##########################                                      ################            ##################                                                                            ######                      ##############      ##|
|##########################                                        ##############              ####################                                                                          ####                        ############        |
|########################                                            ##############              ########################                                                                    ####                          ##########        |
|########################                                            ################              ############################                                                              ####                          ############    ##|
|########################                                              ##############              ##############################                                                            ######                        ##################|
|########################                                                ##########                ################################                                                            ######                    ####################|
|########################                                                ##########              ####################################                                                          ########                  ####################|
|########################                                                  ########              ####################################                                                          ##########                ####################|
|########################                                                    ######                ##############        ############                                                          ##########                  ##################|
|########################                                                    ########              ############            ############                                                        ##########                  ##################|
|######  ################                                                      ######              ############                ########                                                      ############                  ##################|
|####      ################                                                                          ##########                  ########                                                  ################                ##################|
|####        ################                                                                          ##########                  ########                                                  ##############                ##################|
|######        ##############                                                                            ##########                ##########                                                  ##############              ##################|
|########        ############                                                                            ##########                  ########                                                  ##############              ##################|
|######            ########                                                                                ##########                ##########                                                ##############                ################|
|######                                                                                                    ############              ##############                                            ################                ##############|
|######                                                                                                      ##########              ################                                          ################                ##############|
|######                                                                                                      ##########              ##################                                        ################                  ############|
|########                                                                                                    ############            ####################                                      ##################                  ##########|
|##########                                                                                                  ##############        ########################                                      ##################                ##########|
|##############                                                                                              ################################################                                      ##################              ##########|
|##################                                                                                          ##################################################                                    ##################                ########|
|####################                                                                                        ####################################################                                  ####################                ######|
|####################                                                                                        ######################################################                                ####################                ######|
|####################                                                                                          ######################################################                              ######################                ####|
|######################                                                                                        ######################################################                              ######################                  ##|
|######################                                                                                        ########################################################                          ########################                  ##|
|############    ########                                                                                    ############################################################                        ########################                  ##|
|##########        ######                                                                                    ##############################################################                        ######################                  ##|
|##########        ######                                                                                    ################################################################                      ########################                ##|
|##########        ######                                                                                    ##################################################################                      ####################                  ##|
|##########        ########                                                                                  ####################################################################                      ##############                      ##|
|##########        ##########                                                                                ####################################################################                      ################                    ##|
|############    ############                                                                                ######################################################################                    ################                    ##|
|############################                                                                                ##################  ####################################################                  ################                    ##|
|##############################                                                                              ##############################################################################            ######  ######                      ##|
|##################################                                                                        ##################################################################################                    ##                        ##|
|####################################                                                                      ####################              ##############################        ############                                            ##|
|######################################                                                                    ########    ######                  ########################            ############                                            ##|
|####    ############################                                                                        ####      ########                ######################              ############                                            ##|
|####      ##########################                                                                        ########################          ######################              ############                                            ##|
|######    ##########################                                                                        ##########################        ######################              ##############                                          ##|
|####################################                                                                        ##########################        ######################              ##################                                      ##|
|######################################                                                                        ##########################      ####################                  ##################                                  ####|
|######################################                                                                          ########################      ####################                    ################                                ######|
|########################################                                                                          ##############################################                      ##################                              ######|
|########################################                                                                          ##############################################                        ################                                ####|
|########################################                                                                          ################################################                        ################                              ####|
|########################################                                                                          ################################################                            ##############                              ##|
|########################################                                                                            ############  ##################################                            ##############                            ##|
|########################################                                                                            ##########      ################################                            ################                          ##|
|######################################                                                                              ########              ##########################                            ################                          ##|
|######################################                                                                              ######                  ######################                              ################                          ##|
|######################################                                                                              ######                  ######################                              ################                          ##|
|########################################                                                                            ########                  ####################                                ##############                          ##|
|########################################                                                                            ##########                  ##################                                  ############                          ##|
|##########################################                                                                          ##########                    ################                                      ##########                        ##|
|##########################################                                                                          ##########                      ################                                      ########                        ##|
|##########################################                                                                          ############                      ################                                    ##########                      ##|
|##########################################                                                                          ############                        ################                                  ##############                  ##|
|############################################                                                                        ############                          ################                                ##############                  ##|
|##############################################                                                                        ##########                              ################                              ############                  ##|
|##########        ################################                                                                    ########                                  ################                            ############                    |
|##########        ##################################                                                                  ########                                  ##################                          ############                    |
|############    ######################################                                                              ############                              ######################                      ################                ##|
--------------------------------------------------------------------------------------------------------------------------------------------------------------------------------------------------------------------------------------------